9 0 0 0 0 8 0 0 0
0 0 0 4 0 0 0 5 2
1 0 0 5 0 0 0 7 0
0 4 0 0 0 9 0 0 0
8 0 0 1 0 6 0 0 3
7 0 1 0 8 0 0 0 0
0 0 0 0 0 0 0 0 0
4 2 7 0 0 1 0 0 6
5 1 6 0 0 0 0 0 0