7 3 4 8 2 5 6 9 0 
9 2 5 6 4 1 7 8 3 
6 8 1 7 9 3 2 4 5 
8 9 6 5 7 2 1 3 4
1 4 7 9 3 8 5 2 6
2 5 3 1 6 4 8 7 9
4 7 2 3 1 6 9 5 8
5 1 9 4 8 7 3 6 2
3 6 8 2 5 9 4 1 7