6 0 0 0 0 0 2 0 5
0 0 1 0 4 0 6 0 0
2 0 5 0 7 8 9 0 3
0 0 0 0 0 0 0 0 0
0 0 0 1 9 0 3 0 6
0 0 7 0 2 3 1 5 0
0 0 0 7 6 2 0 0 0
0 0 6 3 0 0 7 0 9
0 0 0 0 0 0 0 0 0