0 3 0 8 0 0 0 0 0 
9 0 5 6 0 0 7 0 0 
0 0 1 0 9 3 2 0 0 
8 0 6 5 0 0 0 0 0
0 4 0 0 3 0 0 0 0
0 0 0 0 0 0 0 0 0
4 7 2 3 0 6 9 5 0
0 1 9 4 8 7 0 6 0
3 6 8 2 5 9 0 1 0